################
#@ $   $   $   #
# # # # # # #$ #
#  $ $   $ $   #
# #$# #$# #$# $#
#   #   #   #  #
# #$# #$# #$# $#
#   $   $   $  #
# #$# #$# #$# $#
#   #   #   #  #
# #$# #$# #$# $#
#  $ $   $ $   #
# # # # # # #$ #
#   $   $   @  #
# # # # # # #$ #
################