################
#@  $  $   $   #
# # # # # # #$ #
#   $   #   $  #
# #$# #$# #$# $#
#   $ $ $ $    #
# # #$# #$# #$ #
#     #   #    #
# #$# #$# # #$ #
#    $   $ $   #
# # # # # # #$ #
# $   #   $   @#
# #$# #$# #$# $#
#   $   $   $  #
# # # # # # #$ #
################