################
#@ $     $     #
# # # # # #$#$ #
#   #   #   $  #
# $ #$#$#$# #$ #
#   $     $    #
# #$# # #$# #$ #
#     #   #    #
# # # #$#$# #$ #
#   $     $    #
# $# # # # #$# #
#     $   $    #
# #$#$#$# #$#$ #
#   $     $  @ #
# # # # # # #$ #
################
