################
#@    $    $   #
# # #$# # #$# ##
# $   $   $    #
# # # # # # #$ #
#   $   $   $  #
# #$#$#$# #$#$ #
#     #   #    #
# # # # # # #$ #
# $     $     $#
# # #$# # #$# ##
#   $   $   $  #
# # # # # # #$ #
# $     $   @  #
# #$# # # #$#$ #
################