################
#@    $   $    #
# # # # # # #$ #
#   $   $   $  #
# #$# # # # #$ #
#   $ $ $ $    #
# # #$# #$# #$ #
#    #   #     #
# #$# #$# # #$ #
#    $   $ $   #
# # # # # # #$ #
#  $   $   $   #
# #$# # # # #$ #
#   $     $  @ #
# # # # # # #$ #
################