################
#@ $ $   $ $   #
# # # # # # #$ #
#   $ $ $ $    #
# # # #$# # #$ #
#     #   #    #
# #$#$# #$#$# ##
#  $   $   $   #
# ##$#$#$#$# # #
#     $ $ $    #
# # # #$# # #$ #
#   $   #   $  #
# #$#$#$# #$#$ #
#   $ $   $  @ #
# # # # # # #$ #
################