################
#@    $    $   #
# # # #$# # #$ #
#  $     $     #
# #$#$#$#$# #$ #
#   $   $   $  #
# # # # # # #$ #
#    #   #     #
# $# #$# #$# # #
#  $   $   $   #
# # # #$# # #$ #
#   $   $   $  #
# #$# # # #$#$ #
#   $     $  @ #
# # # # # # #$ #
################