################
#@    $     $  #
# ## # # # # # #
# $    #   $   #
# ##$#$#$#$#$# #
# $    $    $  #
# # ## # ## #$ #
#     #   #    #
# $# #$#$#$# # #
#   $    $     #
# # # # # # # ##
# $     #   $  #
# ##$#$#$#$# # #
#   $     $  @ #
# # # # # # # ##
################