################
#@  $   $   $  #
# # # # # # #$ #
#   $ $ $ $    #
# #$# # # # #$ #
#    #   #     #
# #$#$#$#$#$# $#
#   $   $   $  #
# $# # # # # # #
#   $ $ $ $    #
# #$# # # # #$ #
#   $   $   $  #
# #$#$#$#$#$# $#
# $     $   @  #
# # # # # # #$ #
################