################
#@ $     $     #
# # # # # # #$ #
# $     #     $#
# #$#$#$# #$#$ #
#   $   $   $  #
# # # #$# # #$ #
#   #   #   #  #
# #$# # #$# #$ #
#   $   $   $  #
# # # # # # #$ #
# $     #     $#
# #$#$#$# #$#$ #
#   $     $  @ #
# # # # # # #$ #
################
