################
#@   $   $     #
# # # #$# # #$ #
#   $ $ $ $    #
# #$# # # # #$ #
#    #   #     #
# #$#$#$#$#$# $#
#     $   $    #
# $# # # # # # #
#   $ $ $ $    #
# # # #$# # #$ #
#   $   $   $  #
# #$#$#$#$#$# $#
#   $     $  @ #
# # # # # # #$ #
################