################
#@   $     $   #
#$#$# # # # #$ #
#     #   #    #
# #$#$#$# #$#$ #
#   $     $    #
# ## # # # ##$ #
#     #   #    #
# $#$#$#$#$#$# #
#     $     $  #
# ## # # # ##$ #
#   $   #   $  #
#$#$#$# # #$#$ #
#   $     $  @ #
# # # # # # #$ #
################
