################
################
###$########$###
### #$$$$$$# ###
#$  $$#$$#$$  $#
### # #  # # ###
###$#$#  #$#$###
###$#$#  #$#$###
###$#$#  #$#$###
###$#$#  #$#$###
### # #  # # ###
#$  $$#  #$$  $#
### #$$$$$$# ###
###$########$###
################
################
