################
#@  $    $     #
# # # # # #$# ##
#   $   #   $  #
# #$# #$# #$# $#
#   $   $   $  #
# # #$#$#$#$# ##
#  #   #   #   #
# $# $ $ $ $# $#
#   #   #   #  #
##$#$#$# #$#$# #
#   $   $   $  #
#$# #$# # #$# ##
#   $     $  @ #
#$# #$# # # # ##
################