################
#@     $   $   #
# #$# # # # #$ #
#   $   $   $  #
# # #$#$#$#$# $#
#   #   #   #  #
# #$# #$# #$# $#
#    $   $     #
# #$#$# # # #$ #
#   $   $   $  #
# #$# #$# #$# $#
#   #   #   #  #
# # #$#$#$#$# $#
#   $     $  @ #
# # # # # # #$ #
################