################
#@             #
# #$# # #$# #  #
#              #
#  # # # # # # #
#        $    $#
# # # #$#$#$#$ #
#    $     $   #
#$$#$#$# #$# # #
#    $         #
#$# #$# # #$#$$#
#  # #$# # ##  #
#        $  $  #
# #$# #$# # #  #
#    $    @$   #
################
