################
#@     $     $ #
# #$# # #$# # ##
#  $   $   $   #
# # # # # # #$ #
#   $     $    #
# #$# #$# # #$ #
#    #   #     #
# # #$#$# # #$ #
#    $   $     #
# #$# # #$# #$ #
#  $   $   $   #
# # # # # # #$ #
# $     $    @ #
# # # #$# # #$ #
################