################
#@     $   $   #
# # # # # # #$ #
#   $     $    #
# $ #$#$#$#$#$ #
#     #   #    #
# $# $ $ $ $#$ #
#   #   #   #  #
# # # # # # #$ #
#  $   $   $   #
# $# #$# #$# # #
#    #   #     #
# $# $ $ $ $#@ #
#   #   #   #  #
# $ #$#$#$#$#$ #
################