################
#@     $     $ #
# #$# # # # #$ #
#   $   $   $  #
# # #$#$#$#$# $#
#     #   #    #
# # # #$# # #$ #
#   $   $   $  #
# #$# #$# #$# $#
#     #   #    #
# #$# # # # #$ #
#   $   $   $  #
# # #$#$#$#$# $#
# $     $   @  #
# # # # # # #$ #
################